.___  ___.  _______ .__   __.  __    __  
|   \/   | |   ____||  \ |  | |  |  |  | 
|  \  /  | |  |__   |   \|  | |  |  |  | 
|  |\/|  | |   __|  |  . `  | |  |  |  | 
|  |  |  | |  |____ |  |\   | |  `--'  | 
|__|  |__| |_______||__| \__|  \______/  
                                         

$ 1 player
$ 2 player
$ 3 player
$ 4 player