>---------------<
>---------------<
><   X     X   ><
><             ><
><   X     X   ><
>---------------<
>---------------<