>>-------------<<
><             ><
><   X     X   ><
><             ><
><   X     X   ><
><             ><
>>-------------<<